12 8
11 10 10 10 10 14 10 10 10 13 10 10
20 20 20 20 20 20 26 20 20 25 20 20
40 32 30 15 10 30 30 10 12 30 30 40
40 40 27 20 20 31 30 20 20 22 40 40
40 40 20 20 20 30 30 20 20 24 40 40
40 30 33 10 10 30 30 16 10 30 30 40
27 20 20 20 25 20 26 20 27 20 20 20
10 13 10 10 10 11 10 10 10 14 10 10
