16 12
15 00 00 00 00 00 00 40 40 00 00 00 00 00 00 10
00 10 20 00 00 00 00 40 40 00 00 00 00 20 10 00
00 20 10 20 30 00 00 40 40 00 00 34 20 10 20 00
00 30 20 10 20 30 00 40 40 00 30 20 10 20 30 00
00 40 30 25 10 20 30 40 40 32 20 10 20 30 40 00
40 10 10 10 11 10 10 12 10 10 17 10 10 10 10 40
40 10 10 10 10 13 10 10 10 10 10 10 13 10 10 40
00 40 30 26 10 20 30 40 40 31 20 10 27 30 40 00
00 34 20 10 20 30 00 40 40 00 30 20 10 20 30 00
00 20 10 20 30 00 00 40 40 00 00 30 20 10 20 00
00 10 26 00 00 00 00 40 40 00 00 00 00 20 10 00
10 00 00 00 00 00 00 40 40 00 00 00 00 00 00 10


