20 13
10 10 10 10 10 10 15 10 10 14 10 10 10 10 11 10 10 10 10 10 
26 20 20 20 20 20 20 20 20 20 20 20 20 20 20 20 20 20 20 20 
20 25 20 20 21 20 20 33 30 30 30 30 30 20 20 20 20 20 20 22
20 20 30 30 30 20 20 20 30 30 30 30 20 20 20 32 30 30 27 20
30 30 30 20 20 20 20 10 10 10 10 10 14 20 20 20 23 30 30 30
40 30 30 36 20 20 20 20 20 20 20 20 20 20 20 20 30 30 30 40
40 40 10 10 10 10 10 10 12 14 10 10 10 10 10 10 10 10 40 40
40 30 30 30 23 20 20 20 20 22 20 20 20 20 20 20 30 30 30 40
35 30 30 20 20 20 20 10 10 10 10 10 10 20 20 20 20 30 30 31
20 20 30 30 30 20 20 20 30 30 30 35 20 24 20 30 30 30 20 20
27 20 20 20 23 20 20 30 30 30 30 30 30 20 20 20 20 20 20 20
20 20 24 20 20 20 20 20 20 20 20 20 20 20 20 20 20 27 20 20 
10 11 10 10 10 10 17 10 10 10 10 10 16 10 10 16 10 10 10 10


